{
    "__1": "1",
    "1__1": "1",
    "1__2": "1",
    "1__3": "1",
    "1__4": "1",
    "1__5": "1",
    "1__6": "1",
    "1__7": "1",
    "1_1__1": "1",
    "1_1__2": "1",
    "1_1__3": "1",
    "1_1__4": "1",
    "1_2__1": "1",
    "1_2__2": "1",
    "1_3__1": "1",
    "1_3__2": "1",
    "1_4__1": "1",
    "1_4__2": "1",
    "1_5__1": "1",
    "1_5__2": "1",
    "1_6__1": "1",
    "1_6__2": "1",
    "1_6__3": "1",
    "1_6__4": "1",
    "1_6__5": "1",
    "1_7__1": "1",
    "1_7__2": "1",
    "1_7__3": "1",
    "1_3_1__1": "1",
    "1_3_1__2": "1",
    "1_3_1__3": "1",
    "1_3_1__4": "1",
    "1_3_2__1": "1",
    "1_3_2__2": "1",
    "1_3_2__3": "1",
    "1_6_5__1": "1",
    "1_6_5__2": "1",
    "1_6_5__3": "1",
    "1_6_5__4": "1"
}